14 17
#################
#* @      @     #
#  @      @  +  #
#@@t    @@@@!@@@#
#               #
#               #
#   !!!!!!      #
# # # # # # # # #
# # # # # # # # #
# # # # # # # # #
# # # # # # # # #
# @ @ @ @ ! @ t #
# +             #
#################

t : brick co item time
@: brick k cos item ben trong
#: wall
+: balloon
*: bomer
!: brick co item bom


