13 15
###############
#             #
##     ########
###############
#             #
#####     #####
###############
#             #
###############
###############
#             #
###############
###############
