14 17
#################
#     *       ###
##     ####@#####
###       @    ##
#       @@@     #
#####     #######
#@@@@!!@@     ###
#    @@@      ###
####        #####
#    @@@@@!!!@###
#@@@# @@@@   ####
# # +#     @#####
# #  @@@@@    ###
#################

