14 17
#################
#     *       ###
##     ####@#####
### 1       #####
#       @@@   ###
#####     #######
#@@@@!!@@     ###
#    @@@      ###
####        #####
#    @@@@@!!!@###
#      @@@@   ###
###         #####
#    @@@@@    ###
#################

