14 17
#################
#     *       ###
##     ##########
#################
#             ###
#####     #######
#             ###
#             ###
#################
#             ###
#             ###
#################
#             ###
#################

