14 17
#################
#@@@  *   @@@ ###
##     ####@#@@@#
###  @@@ @@@#####
#@@@    @@@   ###
#####     #######
#             ###
#    @@@@     ###
####        @@@##
#   @@@       ###
#@@@   @@@@   ###
###         #####
#    @@@@@@@@ ###
#################

