14 17
#################
#     *       ###
##     #### #####
###         #####
#             ###
#####     #######
#             ###
#             ###
####        #####
#             ###
#             ###
###         #####
#             ###
#################

