14 17
#################
#     *       ###
##     ####@#####
###         #####
#       @@@   ###
#####     #######
#             ###
#    @@@@     ###
####        #####
#             ###
#      @@@@   ###
###         #####
#    @@@@@    ###
#################

